Trial Number: 1
This Worked:
Hand: 

Preloaded draws to Hand: Tenki 1, blank 46, blank 48, blank 35, blank 9, blank 69, blank 12, blank 16, blank 30, blank 26, TB Fraktall 2, blank 73, blank 53, TB Kitt 2, blank 51, 

Moved TB Fraktall from Deck to Hand	(set hand)
Moved TB Keras from Deck to Hand	(set hand)
Placed blank in Hand	(set hand)
Placed blank in Hand	(set hand)
Placed blank in Hand	(set hand)
Moved TB Fraktall from Hand to GY	(Frak eff)
Moved TB Kitt from Deck to GY	(Frak eff)
Moved TB Nervall from Deck to GY	(Kitt send)
Moved TB Mercourier from Deck to Hand	(Nerv add)
Moved TB Keras from Hand to Monster Zone	(Keras eff)
Moved TB Mercourier from Hand to GY	(Keras eff)
Moved TB Mercourier from GY to Banish	(keras summon link)
Moved TB Fraktall from GY to Banish	(keras summon link)
Moved TB Kitt from GY to Banish	(keras summon link)
Moved TB Nervall from GY to Banish	(keras summon link)
Removed Shuraig from ED	(keras summon link)
Placed Imp Shuraig in EMZ	(keras summon link)
Moved Albion the Shrouded from Deck to Hand	(Merc eff)
Moved Albion the Shrouded from Hand to Deck	(Shrouded eff)
Moved Branded Blade from Deck to GY	(Shrouded eff)
Drew Tenki to Hand	(Shrouded eff)
Moved Tenki from Hand to S/T Zone	(Tenki eff)
Moved TB Fraktall from Deck to Hand	(Tenki eff)
Moved Branded Blade from GY to Banish	(Blade eff)
Moved TB Mercourier from Banish to Hand	(Blade eff)
Moved TB Keras from Monster Zone to GY	(Summon Ferrijit)
Moved Imp Shuraig from EMZ to GY	(Summon Ferrijit)
Moved Ferrijit from ED to EMZ	(Summon Ferrijit)
Moved TB Nervall from Deck to Hand	(Omen eff to add)
Moved TB Fraktall from Hand to Monster Zone	(Ferri eff to spec)
Moved TB Fraktall from Monster Zone to GY	(Summon Ferrijit)
Moved Ferrijit from EMZ to GY	(Summon Ferrijit)
Moved Ferrijit from ED to EMZ	(Summon Ferrijit)
Drew blank to Hand	(Ferri eff to draw)
Moved blank from Hand to Deck	(Put back 1)
Moved TB Nervall from Hand to Monster Zone	(Ferri eff to spec)
Moved TB Fraktall from GY to Banish	(nerv summon link)
Moved TB Keras from GY to Banish	(nerv summon link)
Removed Ferrijit from ED	(nerv summon link)
Placed Imp Ferrijit in EMZ	(nerv summon link)
Moved TB Nervall from Monster Zone to GY	(Summon Brumm)
Moved Ferrijit from EMZ to GY	(Summon Brumm)
Moved Bearbrumm from ED to EMZ	(Summon Brumm)
Moved blank from Hand to GY	(Brumm eff to spec)
Moved blank from Hand to GY	(Brumm eff to spec)
Moved TB Kitt from Banish to Monster Zone	(Brumm eff to spec)
Moved TB Nervall from GY to Banish	(Kitt summon link)
Moved Ferrijit from GY to Banish	(Kitt summon link)
Moved DDL from ED to EMZ	(Kitt summon link)
Moved TB Kitt from Monster Zone to GY	(Summon Verte)
Moved Imp Ferrijit from EMZ to GY	(Summon Verte)
Moved Verte from ED to EMZ	(Summon Verte)
Moved Branded Fusion from Deck to GY	(Eff Verte)
Moved albaz from Deck to GY	(Eff Verte)
Moved Bearbrumm from EMZ to GY	(Eff Verte)
Placed Mirrorjade in Monster Zone	(Eff Verte)
Moved TB Revolt from Deck to Hand	(Brumm eff to add)
Moved blank from Hand to Deck	(Put back 1)
Moved TB Revolt from Hand to S/T Zone	(Place revolt)


Number of successes: 1 out of 1
Number of timeouts: 0
Probability: 1.0
